3333333333
3333333333
3333333333
3333333333
3333333333
3333333333
3333333333
3333333333
3333333333
3333333333

5555555555
1000000001
1000000001
1000000001
1000000001
1000000001
1000000001
1000000001
1000000001
1111111111

1111111111
1000000001
1000000001
1000000001
1000000001
1000000001
1000000001
1000000701
1000000001
1111111111

1111111111
1000000001
1000000001
1000000001
1000000001
1000000001
1000000001
10a0000001
1000000001
1111111111

1111111111
1000000001
1000000001
1000000001
1000000001
1000000001
1000000001
1000000001
1000000001
1111111111

1111111111
1000000001
1000000001
1000000001
1000000001
1000000001
1000000001
1000000001
1000000001
1111111111

1111111111
1000000001
1000000001
1000000001
1000000001
1000000001
1000000001
10a0000001
1000000001
1111111111
